1,1,1,1,1,1,1,1,1,1,1,1
1,1,1,1,1,1,1,1,1,1,1,1
1,1,1,1,1,2,2,1,1,1,1,1
1,1,1,1,2,2,2,2,1,1,1,1
1,1,1,1,1,1,1,1,1,1,1,1
1,2,2,1,1,1,1,1,2,2,1,1
1,1,2,1,1,1,1,1,1,2,2,1
1,1,1,2,1,1,1,1,1,1,1,1
1,1,1,2,1,1,2,2,1,1,1,1
1,1,1,1,1,1,2,2,1,1,1,1
1,1,1,1,1,1,1,1,1,1,1,1
1,1,1,1,1,1,1,1,1,1,1,1
A:6,6
E:4,7|9,5|4,9|1,6