1,1,1,1,1,1,1,1,1,1,1,1
1,1,2,1,1,1,1,2,1,1,1,1
1,1,2,2,2,1,1,2,2,2,1,1
1,1,2,2,2,1,1,2,2,2,1,1
1,1,2,2,2,1,1,2,2,1,1,1
1,1,1,1,1,1,1,1,1,1,1,1
1,1,1,1,1,1,1,1,1,1,1,1
1,1,1,2,2,1,1,2,2,2,2,1
1,1,2,2,2,1,1,2,2,2,1,1
1,1,2,2,2,1,1,2,2,2,1,1
1,1,1,1,2,1,1,1,2,2,1,1
1,1,1,1,1,1,1,1,1,1,1,1
A:6,5
E:5,7|6,2|0,5|9,5